WWWWWWWWWWWWWWWWWWWWWWWWW
WPFFFPFFPFFFPFFFPFFPFFFPW
WFWWWFWWWWWFWFWWWWWFWWWFW
WFWPFFFPFFFFWFFFFPFFFPWFW
WFWFWWWFWFWFWFWFWFWWWFWFW
WPFFFPFFWFWFPFWFWFFPFFFPW
WFWWWWWFWFWWWWWFWFWWWWWFW
WPFFPFFPWFFFFFFFWPFFPFFPW
WFWWWWWFWWWWWWWWWFWWWWWFW
WPFFFPFFFPCFFFPSFFFPFFFPW
WFWFWWWFWFWWWWWFWFWWWFWFW
WFWPFFFPFFFFPFFFFPFFFPWFW
WFWWWFWWWWFWWWFWWWWFWWWFW
WPFFFPFFPFFFPFFFPFFPFFFPW
WWWWWWWWWWWWWWWWWWWWWWWWW